AND	AH N D
AND(2)	AE N D
BATTERY	B AE T ER IY
BITCOIN	B IH T K OY N
BROWSER	B R AW Z ER
CURENCY	K Y UH R AH N S IY
DATE	D EY T
EMAIL	IY M EY L
FILE	F AY L
GOOGLE	G UW G AH L
IMAGE	IH M AH JH
IMAGE(2)	IH M IH JH
MANAGER	M AE N AH JH ER
MANAGER(2)	M AE N IH JH ER
MUSIC	M Y UW Z IH K
OPEN	OW P AH N
PLAY	P L EY
PLAYER	P L EY ER
SEARCH	S ER CH
SHOW	SH OW
STATUS	S T AE T AH S
STATUS(2)	S T EY T AH S
TELL	T EH L
TIME	T AY M
VALUE	V AE L Y UW
VIDEO	V IH D IY OW
WEATHER	W EH DH ER
YOUTUBE	Y UW T UW B
